


NO ./textures/north.xpm

SO ./textures/south.xpm

WE ./textures/west.xpm
EA ./textures/east.xpm
F    120,80,90
C  0,50,170
1111111111
100E000000
11111111111